..............##################
..............##################
..............##################
..............##################
..............##################
..............##################
#.##############################
#.#.......#...##################
#.#.###.#.#.#.##################
#...#...#...#.##################
##.##.###.###.##################
#.....#...#...##################
#.###.#.#.#.####################
#.#.....#.....##################
################################
............#...................
............#...................
................................
................................
################################
......#.#...#...................
#####.#.#.#.#...................
......#.#.#.#...................
.######...#.#...................
........###.#...................
#####.#.....#...................
....#.#####.#...................
#.#.........#...................
#.#####.###.#...................
#.....#.#.#.#...................
#######.#.#.#...................
............#...................